1111111111
1X01111001
1100000011
1100200011
1100000011
1001111001
1111111111
