1111111111
1000110001
1000000111
1000000001
100X011101
1000010101
1111111111
