13141511
2X000002
10000001
50100503
10000001
40200404
10000001
30300405
10000001
20000002
11514131
