11111
10001
10X01
10001
11111
