111111111
100000001
1000X0000
100000001
111111111
