111111111
000000001
100000001
100X00001
111111111
