111111111
10X000001
100000001
100000000001
111111111
