111111111
1X0000001
100000001
100000001
111011111
